33333333333333333333
33333333333333333333
33333333333333333333
33333233323333333333
33333233323333333333
33233233323332333333
33323333333323333333
33332233332233333333
33333322224333333333
33333333333333333333
33333333333333333333
33333333333333333333
33333333333333333333
33333333333333333333
33333333333333333333
33333333333333333333
33333333333333333333
33333333333333333333
33333333333333333333
