00 00 00 00 00 00 00 00 00 00 00 00 00 00 00 00 00 00 00 00
00 00 00 00 00 00 00 00 00 00 00 00 00 00 00 00 00 00 00 00
00 00 00 00 00 00 00 00 00 00 00 00 00 00 00 00 00 00 00 00
00 00 00 00 00 00 00 00 00 00 00 00 00 00 00 00 00 00 00 00
00 00 00 00 00 00 00 00 00 00 00 00 00 00 00 00 00 00 00 00
00 00 00 00 00 00 00 00 00 00 00 00 00 00 00 00 00 00 00 00
00 00 00 00 00 00 00 00 00 00 00 00 00 00 00 00 00 00 00 00
00 00 00 00 00 00 00 00 00 00 00 00 00 00 00 00 00 00 00 00
00 00 00 00 00 00 00 00 00 00 00 00 00 00 00 00 00 00 00 00
00 00 11 11 12 12 14 14 11 11 12 12 14 14 11 11 12 12 00 00
00 00 14 11 11 12 12 14 14 11 11 12 12 14 14 11 11 12 00 00 
00 00 14 14 11 11 12 12 14 14 11 11 12 12 14 14 11 11 00 00
00 00 12 14 14 11 11 12 12 14 14 11 11 12 12 14 14 11 00 00
00 00 12 12 14 14 11 11 12 12 14 14 11 11 12 12 14 14 00 00
00 00 11 12 12 14 14 11 11 12 12 14 14 11 11 12 12 14 00 00
00 00 11 11 12 12 14 14 11 11 12 12 14 14 11 11 12 12 00 00
00 00 14 11 11 12 12 14 14 11 11 12 12 14 14 11 11 12 00 00

99 // EOF
